++++++++++++++++++++++++++++++
+  00      0        0        +
+          0         0       +
+     0*             00000   +
+ 0    0             0 0x0   +
+ 00                         +
+       0                    +
+                        0   +
+    0    0              0   +
+     00  0          0       +
+    0       0   0           +
+           00               +
+0                    0      +
+0               00   0      +
+                     0      +
+     0              0       +
+ 000                        +
++++++++++++++++++++++++++++++